invite -  Get invite link of chats where the bot is admin. ğŸ”—
logs -  View recent error logs. ğŸ“—
stats -  Get status of files in the database. ğŸ“Š
connections -  See all connected groups. ğŸŒ
settings -  Open settings menu. âš™ï¸
filter -  Add manual filters. ğŸ”
filters -  View filters. ğŸ“š
connect -  Connect to PM. ğŸ”—
disconnect -  Disconnect from PM. ğŸ”—
del -  Delete a filter. ğŸ—‘ï¸
delall -  Delete all filters. ğŸ—‘ï¸
deleteall -  Delete all indexed files. ğŸ—‘ï¸
delete -  Delete a specific file from the index. ğŸ—‘ï¸
info -  Get user information. ğŸ”
id -  Get TG IDs. ğŸ†”
imdb -  Fetch info from IMDb. ğŸ¬
search -  Search from various sources. ğŸ”
start -  Start the bot. ğŸ
setskip -  Set the number of messages to skip when indexing files. ğŸ”¢
users -  Get a list of users and their IDs. ğŸ§‘â€ğŸ¤â€ğŸ§‘
chats -  Get a list of chats and their IDs. ğŸ’¬
leave -  Leave a chat. ğŸšª
disable -  Disable a chat. ğŸ”™
enable -  Re-enable a chat. ğŸ”›
ban -  Ban a user. ğŸš«
unban -  Unban a user. ğŸ”“
channel -  Get a list of connected channels. ğŸ“º
broadcast -  Broadcast a message to all users. ğŸ“¢
grp_broadcast -  Broadcast a message to all connected groups. ğŸš¨
gfilter -  Add global filters. ğŸ§¼
gfilters -  View the list of all global filters. ğŸ“
delg -  Delete a specific global filter. ğŸš«
delallg -  Delete all global filters from the bot's database. ğŸš®
deletefiles -  Delete PreDVDRip and CamRip files from the bot's database. ğŸ—‘ï¸